################################
#                              #
#                              #
#                              #
#                              #
#                              #
#                              #
#                              #
#                              #
#          #########           #
#                              #
#                   #####      #
#                              #
#                        #     #
#                        #     #
#         ############   #     #
#                        #     #
#        c               #     #
#                              #
#                              #
#                              #
#                              #
#                              #
################################
